@.........
#########.
........#.
.######.#.
.#....#.#.
.#.#..#.#.
.#.####.#.
.#......#.
.########.
..........